49 49 49 49 49 49 49 49 49 49 49 49 49 49 49 49 49 49 49 49 49 49 49 49 49 49 49 49 49 49 49 49 49 49 49 49 49 49 49 49 49 49 49 49 49 49 49 49 49 49 
49 49 49 49 49 49 49 49 49 49 49 49 49 49 49 49 49 49 49 49 49 49 49 49 49 49 49 49 49 49 49 49 49 49 49 49 49 49 49 49 49 49 49 49 49 49 49 49 49 49 
49 49 49 49 49 49 49 49 49 49 49 49 49 49 49 49 49 49 49 49 49 49 49 49 49 49 49 49 49 49 49 49 49 49 49 49 49 49 49 49 49 49 49 49 49 49 49 49 49 49 
49 49 49 49 49 49 49 49 49 49 49 49 49 49 49 49 49 49 49 49 49 49 49 49 49 49 49 49 49 49 49 49 49 49 49 49 49 49 49 49 49 49 49 49 49 49 49 49 49 49 
49 49 49 49 49 49 49 49 49 49 49 49 49 49 49 49 49 49 49 49 49 49 49 49 49 49 49 49 49 49 49 49 49 49 49 49 49 49 49 49 49 49 49 49 49 49 49 49 49 49 
49 49 49 49 49 49 49 49 49 49 49 49 49 49 49 49 49 49 49 49 49 49 49 49 49 49 49 49 49 49 49 49 49 49 49 49 49 49 49 49 49 49 49 49 49 49 49 49 49 49 
49 49 49 49 49 49 49 40 40 40 40 40 40 40 40 40 40 40 40 40 40 40 40 40 40 40 40 40 40 40 40 40 40 40 40 40 40 40 40 40 40 40 40 49 49 49 49 49 49 49 
49 49 49 49 49 49 49 40 39 39 40 40 40 40 40 40 40 40 40 40 40 40 40 40 40 40 40 40 40 40 40 40 40 40 40 40 40 40 40 40 40 40 40 49 49 49 49 49 49 49
49 49 49 49 49 49 49 40 39 39 40 40 40 40 40 39 39 39 39 39 39 40 40 40 40 40 40 40 40 40 40 39 39 39 39 39 39 40 40 40 40 40 40 49 49 49 49 49 49 49 
49 49 49 49 49 49 49 40 40 39 40 40 40 40 39 39 39 39 39 39 39 39 40 40 40 40 40 40 40 40 39 39 39 39 40 40 39 40 40 40 40 40 40 49 49 49 49 49 49 49 
49 49 49 49 49 49 49 40 40 39 39 39 39 39 39 39 39 39 39 39 39 39 40 40 40 40 39 39 39 39 39 39 39 40 40 40 39 39 40 40 40 40 40 49 49 49 49 49 49 49 
49 49 49 49 49 49 49 40 40 40 40 40 40 40 39 39 39 39 39 39 39 39 40 40 40 39 39 39 39 39 39 39 40 40 40 40 40 39 40 40 40 40 40 49 49 49 49 49 49 49 
49 49 49 49 49 49 49 40 40 40 40 40 40 40 40 39 39 39 39 39 39 40 40 40 39 39 39 39 39 39 40 40 40 40 40 40 40 39 39 40 40 40 40 49 49 49 49 49 49 49 
49 49 49 49 49 49 49 40 40 40 40 40 40 40 40 40 40 40 39 40 40 40 40 39 39 39 39 40 40 40 40 40 40 40 40 40 39 39 39 39 40 40 40 49 49 49 49 49 49 49 
49 49 49 49 49 49 49 40 40 40 40 40 40 40 40 40 40 40 39 40 40 40 39 39 39 40 40 40 40 40 40 40 40 40 40 39 39 39 39 39 40 40 40 49 49 49 49 49 49 49 
49 49 49 49 49 49 49 40 40 40 40 40 40 40 40 39 39 39 39 39 40 40 39 39 39 40 40 40 40 40 40 40 40 40 40 39 39 39 39 39 39 40 40 49 49 49 49 49 49 49
49 49 49 49 49 49 49 40 40 40 40 40 40 39 39 39 40 39 39 39 40 40 39 40 40 40 40 40 40 40 40 40 40 40 39 39 39 39 39 39 39 40 40 49 49 49 49 49 49 49
49 49 49 49 49 49 49 40 39 39 40 40 40 40 40 40 40 40 39 40 40 40 39 40 40 40 39 39 39 39 40 40 39 39 39 40 40 39 39 39 40 40 40 49 49 49 49 49 49 49
49 49 49 49 49 49 49 40 39 39 39 39 39 40 40 40 40 40 39 40 40 40 39 40 40 51 39 39 39 39 40 39 39 40 40 40 40 40 39 40 40 40 40 49 49 49 49 49 49 49
49 49 49 49 49 49 49 40 39 39 39 39 39 40 40 40 40 40 39 40 40 40 39 40 40 40 39 39 39 39 39 39 40 40 40 40 40 40 39 40 40 40 40 49 49 49 49 49 49 49
49 49 49 49 49 49 49 40 39 39 39 39 39 40 40 40 40 40 39 40 40 40 39 40 40 40 40 39 39 39 40 40 40 40 40 40 40 40 39 40 40 40 40 49 49 49 49 49 49 49
49 49 49 49 49 49 49 40 39 39 39 39 39 40 40 40 40 40 39 40 40 40 39 39 40 40 40 40 40 40 40 40 40 40 40 40 40 40 39 40 40 40 40 49 49 49 49 49 49 49 
49 49 49 49 49 49 49 40 40 40 39 40 40 40 40 40 40 40 39 40 39 39 39 39 40 40 40 40 40 40 40 40 40 40 40 40 40 40 39 40 40 40 40 49 49 49 49 49 49 49 
49 49 49 49 49 49 49 40 40 40 39 40 40 40 40 40 40 40 39 40 40 40 40 40 40 40 40 40 40 40 40 40 40 40 40 40 40 39 39 39 39 40 40 49 49 49 49 49 49 49 
49 49 49 49 49 49 49 40 40 40 39 40 40 40 39 39 39 39 39 39 39 39 40 40 40 40 40 40 40 40 40 40 40 40 39 39 39 39 39 39 39 40 40 49 49 49 49 49 49 49 
49 49 49 49 49 49 49 40 40 40 39 40 40 39 39 39 39 39 39 39 39 39 39 40 40 40 40 40 40 40 40 40 39 39 39 39 39 39 39 39 39 40 40 49 49 49 49 49 49 49 
49 49 49 49 49 49 49 40 40 40 39 39 39 39 39 39 39 39 39 39 39 39 39 40 40 40 40 40 40 40 40 40 39 39 39 39 39 39 39 39 39 40 40 49 49 49 49 49 49 49 
49 49 49 49 49 49 49 40 40 40 39 39 39 39 39 39 39 39 39 39 39 39 39 40 40 40 40 40 40 40 40 40 39 39 39 39 39 39 39 39 39 40 40 49 49 49 49 49 49 49 
49 49 49 49 49 49 49 40 40 40 40 40 40 40 39 39 39 39 39 39 39 39 39 39 39 39 39 39 39 39 39 39 39 39 39 39 39 40 40 39 39 40 40 49 49 49 49 49 49 49 
49 49 49 49 49 49 49 40 40 40 40 40 40 40 40 40 40 39 39 40 40 40 40 40 40 40 39 40 40 40 40 40 39 39 39 40 40 40 40 39 39 40 40 49 49 49 49 49 49 49 
49 49 49 49 49 49 49 40 40 40 40 40 40 40 40 40 40 39 39 40 40 40 40 40 40 40 39 40 40 40 40 40 40 40 40 40 40 40 39 39 39 40 40 49 49 49 49 49 49 49 
49 49 49 49 49 49 49 40 40 40 40 40 40 40 40 40 40 39 39 40 40 40 40 40 40 40 39 40 40 40 40 40 40 40 40 40 40 40 40 39 39 40 40 49 49 49 49 49 49 49 
49 49 49 49 49 49 49 40 40 40 40 40 40 40 40 40 40 39 39 40 40 40 40 40 40 40 39 40 40 40 40 40 40 40 40 40 40 40 40 40 40 40 40 49 49 49 49 49 49 49 
49 49 49 49 49 49 49 40 40 40 40 40 40 40 40 40 40 39 39 40 40 40 40 40 40 39 39 39 40 40 40 40 40 40 40 40 40 40 40 40 40 40 40 49 49 49 49 49 49 49 
49 49 49 49 49 49 49 40 40 40 40 40 40 40 40 40 40 39 39 40 40 40 40 40 40 39 39 39 40 40 40 40 40 40 40 40 40 40 40 40 40 40 40 49 49 49 49 49 49 49 
49 49 49 49 49 49 49 40 40 40 40 40 40 40 40 39 39 39 39 39 39 40 40 40 40 40 40 40 40 40 40 40 40 40 40 40 40 40 40 40 40 40 40 49 49 49 49 49 49 49 
49 49 49 49 49 49 49 40 40 40 40 40 40 40 40 39 39 39 39 39 39 40 40 40 40 40 40 40 40 40 40 40 40 40 40 40 40 40 40 40 40 40 40 49 49 49 49 49 49 49 
49 49 49 49 49 49 49 40 40 39 39 39 39 39 39 39 39 39 39 39 39 40 40 40 40 40 40 40 40 40 40 40 40 40 40 40 39 39 39 39 39 40 40 49 49 49 49 49 49 49 
49 49 49 49 49 49 49 40 40 39 40 40 40 40 40 39 39 39 39 39 39 40 40 40 40 40 40 40 40 40 40 40 39 39 39 39 39 39 40 40 39 40 40 49 49 49 49 49 49 49 
49 49 49 49 49 49 49 40 40 39 40 40 40 40 40 39 39 39 39 39 39 40 40 40 40 40 40 40 40 40 40 39 39 39 39 39 39 40 40 40 39 40 40 49 49 49 49 49 49 49 
49 49 49 49 49 49 49 40 39 39 39 40 40 40 40 39 39 39 39 39 39 39 39 39 39 39 39 39 39 39 39 39 39 39 39 39 39 40 40 40 39 40 40 49 49 49 49 49 49 49 
49 49 49 49 49 49 49 40 39 51 39 40 40 40 40 40 40 40 40 40 40 40 40 40 40 40 40 40 40 40 40 40 39 39 39 39 39 40 40 40 39 40 40 49 49 49 49 49 49 49
49 49 49 49 49 49 49 40 39 39 39 40 40 40 40 40 40 40 40 40 40 40 40 40 40 40 40 40 40 40 40 40 40 40 40 40 40 40 40 40 40 40 40 49 49 49 49 49 49 49 
49 49 49 49 49 49 49 40 40 40 40 40 40 40 40 40 40 40 40 40 40 40 40 40 40 40 40 40 40 40 40 40 40 40 40 40 40 40 40 40 40 40 40 49 49 49 49 49 49 49 
49 49 49 49 49 49 49 49 49 49 49 49 49 49 49 49 49 49 49 49 49 49 49 49 49 49 49 49 49 49 49 49 49 49 49 49 49 49 49 49 49 49 49 49 49 49 49 49 49 49 
49 49 49 49 49 49 49 49 49 49 49 49 49 49 49 49 49 49 49 49 49 49 49 49 49 49 49 49 49 49 49 49 49 49 49 49 49 49 49 49 49 49 49 49 49 49 49 49 49 49 
49 49 49 49 49 49 49 49 49 49 49 49 49 49 49 49 49 49 49 49 49 49 49 49 49 49 49 49 49 49 49 49 49 49 49 49 49 49 49 49 49 49 49 49 49 49 49 49 49 49 
49 49 49 49 49 49 49 49 49 49 49 49 49 49 49 49 49 49 49 49 49 49 49 49 49 49 49 49 49 49 49 49 49 49 49 49 49 49 49 49 49 49 49 49 49 49 49 49 49 49 
49 49 49 49 49 49 49 49 49 49 49 49 49 49 49 49 49 49 49 49 49 49 49 49 49 49 49 49 49 49 49 49 49 49 49 49 49 49 49 49 49 49 49 49 49 49 49 49 49 49 
49 49 49 49 49 49 49 49 49 49 49 49 49 49 49 49 49 49 49 49 49 49 49 49 49 49 49 49 49 49 49 49 49 49 49 49 49 49 49 49 49 49 49 49 49 49 49 49 49 49 
